8
8
Q000000V
MUIMIMUM
UIIWIT00
0IMIUU00
0IMM0U00
WIIIUM00
XMI00II0
TUUIIIIE