10
10
X00000000E
MMMUMUMUMU
U000000000
MMUMUMUMUM
000000000I
MMUMUMUMUI
X0000000T0
MUMMMMUMMP